00000000000000000000000000000000000000000000000000000000000000000000000000000000000000000000000000000000000000000000000000000000000000000000000000000000000000000000000000000000000000000000000000000000
00000000000000000000000000000000000000000000000000000000000000000000000000000000000000000000000000000000000000000000000000000000000000000000000000000000000000000000000000000000000000000000000000000000
11111111111111111111111111111111111111111111111111111111111111111111111111111111111111111111111111111111111111111111111111111111111111111111111111111111111111111111111111111111111111111111111111111111
00000000000000000000000000000000000000000000000000000000000000000000000000000000000000000000000000000000000000000000000000000000000000000000000003000000000000000030000000000000000000000000000000000002
00000004444000000000000000000000040000000000000000000000000000000777777000000030000000000000000000000000000000000000000000000000000000000000000000300000000000000303000000000000000000000000000000000002
00000000000400000000000000000000400000000000003333333333333333333333333333333300000000000000000000000000000000000000000000000000000000000000000000030000000000003000300000000300000000330000000030000002
00000000000040004044000000000040000000000000030003333333333333333333333333333000000000000000000000000000000000000000000000000000000000000000000000000000000000030000030000003030000003003000000303000002
00000000000004400000400000004400000000000303000060300303660600000000336000030000000000000000000000000000000000000000000000000000000000000000000000003000000003300000003000030003000030000300033000300002
00000000000000000000040000040000000003030000000003303600333067777777060003300000000000000000000000000000000000000000005054054000000000000000000000000300000030000000000300300000300300000030300000033002
00000000000000000000000440000000000030000000006006060006060330600066060330000000000000000000040450000000000000000050440000000450000000000000045400000030000000000000000033000000033000000003000000000332
00000000000000000000000000000000030000000000600600000000000600666000000000000000000000000064560005460000000000004500000000000000500000000455000450000003000300000000000000000000000000000000000000000002
00000000000000000000000000000030300000000000000000000000000660000000000000000000000000005400000000005460564000546000000000000000005000054000000056000000303000000000000000000000000000000000000000000002
00000000033333333330000000000300000600000003333333333333333333333333333333333333300000000000000000000000000054000000000000000000000054000000000000000000030000000000000000000000000000000000000000000002
00000000000000333333000003030000000000000003333333333333333333333333333333333333333333333333333333333333333333333333333333333333333333333333333333333333333333333333333333333333333333333333333333333332
00000000000000003333333300000000000000000000550000000000000000000000000000000000000000000000000000000000000000000000000000300000000030000003330000000033300000003300000000303000000300000000003030300002
00000000000000000000000000000000000600000000500000000000000000000000000054000000000045040000000000000005400000000000040500030300000303000000003000000300030000030030000003000300033030000300030000033002
00000000000000000000000000000000055050005050000000000000000000000050445000540000054000004500000000045540004545040405000000000030033000300030000300003000003000300003000030000030300003003030300000000302
00000000044444444444000000000505000000500000000000000000000000000400000000000404000000000005404504000000000000000000000000000003300000033300000030030000000003000000300300000003000000330003000000000032
00000000000000000000000000000000000000000000000000000000000000050000000000000000000000000000000000000000000000000000000000000000000000000000000003300000000330000000033000000000000000000000000000000002
11111111111111111111111111111111111111111111111111111111111111111111111111111111111111111111111111111111111111111111111111111111111111111111111111111111111111111111111111111111111111111111111111111111