0000000000000000000000000000000000000000000000000000000000000000000000000000000000000000000000000000000000000000000000000000000000000000000000000000000000000000000000000000000000000000000000000000000000000000000000000000000000000000000000000000000000000000000000000000000000000000000000000000000000000000000000000000000000000000000000000000000000000000000000000000000000000000000000000000000000000000
0000000000000000000000000000000000000000000000000000000000000000000000000000000000000000000000000000000000000000000000000000000000000000000000000000000000000000000000000000000000000000000000000000000000000000000000000000000000000000000000000000000000000000000000000000000000000000000000000000000000000000000000000000000000000000000000000000000000000000000000000000000000000000000000000000000000000000
1111111111111111111111111111111111111111111111111111111111111111111111111111111111111111111111111111111111111111111111111111111111111111111111111111111111111111111111111111111111111111111111111111111111111111111111111111111111111111111111111111111111111111111111111111111111111111111111111111111111111111111111111111111111111111111111111111111111111111111111111111111111111111111111111111111111111111
0000000011111000100010000100011111000000000100011111000000005000000050005005555500044444000500050000010000000055500018000500044444000400000088888000080001008888100400000000000088888888888888888888888888888888888888888888888888880000000000000000000000000000000000000000000000000000000000000000000000000000000000000000000000000000000000000000000000000000000000000000000000000000000000000000000000000002
0000000000100000100010000100010000000000000100010000000000050500000050005005000000040004000055500000040000000500050070700500080000000400000050000000010008004000000400000000000000000000000000000000000000000000000000000088888888888888888888888888888888888888888888888888888888000000000000000000000000000000000000000000000000000000000000000000000000000000000000000000000000000000000000000000000000000002
0000000000100000111110000100011111000000000400055555000004444444000005050001111100055555000006000000050000000700070050070500077777000400000077777000005040004444400400000000000000000000000000000000000000000000000000000000000000000000000000000000000000000000000000888888888888888888888888888888888888888888000000000000000000000000000000000000000000000000000000000000000000000000000000000000000000000002
0000000000100000100010000100000001000000000400000004000000100010000005050004000000050500000005000000010000000400040040007500080001000500000040000000004050008000000400000000000000000000000000000000000000000000000000000000000000000000000000000000000000000000000000000000000000000000000000000088888888888888888888888888888888888888880000000000000000000000000000000000000000000000000000000000000000000002
0000000000100000100010000100011111000000000100011111000000100010000000500004444400050050000005000000066660000044400080000500055555000555550044888000000800005555500555551000000000000000000000000000000000000000000000000000000000000000000000000000000000000000000000000000000000000000000000000000000000000000000000000000088888888888888888888888888888888888888888888888888888888888888888888888888888888882
0000000000000000000000000000000000000000000000000000000000000000000000000000000000000000000000000000000000000000000000000000000000000000000000000000000000000000000000000000000000000000000000000000000000000000000000000000000000000000000000000000000000000003000000000000000000000000000000000000000000000000000000000000000000000000000000000000000000000000000000000000000000000000000000000000000000000002
0000000000000000000000000000000000000000000600000000000000000000000000000000000000000000000000000000000000000000000000000000000000000000000000000000000000000000000000000000000000000000000000000000000000000000000000000000000000000000000000000000003000000030333330000000000070700000000000700000000000000000000000000000000000000000000000000000000000000000000000000000373737373737373737373737373737377732
0000000000000000000000000000000000000000000000000000000000000000000000000000000000000000000000000000000000000000000000000000000000000000000000000000000000000000000000000000000000000000000000000000000000000000000000000000000000000000000000000000000030003000000000000000070700070000000700007700000000000000000000000000000000000000000000000000000000000000000000000000000000000000888888888888888888888882
0000000000000000000000000000000000000000000000000000000000000000000000000000000000000000000000000000000000000000000000000000000000000000000000000000000000000000000000000000000000000000000000000000000000000000000000000000000000000000000000000000000003030000000003007070700000007070007000000070000000000000000000000000000000000000000000000000000000000000000000000088888888888888888880000000000000000002
0000000000000000000000000000000000000006000000000000000000000000000000000000000000000000000000000000000000000000000000000000000000000000000000000000000000000000000000000000000000000000000000000000000000000000000000000000000000000000000000000000000000000000000000330000000000000000700000000000000000000000000000000000000000000000000000000000000000888888888888888888888888888000000000000000000000000002
0000000000000000000000000000000000000000000000000000000000000000000000000000000000000000000000000000000000000000000000000000000000000000000000000000000000000000000000000000000000000000000000000000000000000000000000000000000000000000000000000000000000000000000000000000000000000000000000000007000000000000000000000000000000000008888888888888888888888888888800000000000000000000000000000000000000000002
0000000000000000000000000000000000000000000000000006000000000000000888888888888888888888888888888888888888888888888888888888888888888888888888888888888888888888888888888880000000000000000000000000000000000000000000000000000000000000000000000000000000000000000000000000000000000000000000000000000000000000088888888888888888888888888880000000000000000000000000000000000000000000000000000000000000000002
0000000000000000000000000000000000000000000000000000000000000000000100600000000006060600000600000066000600066000600600060060000600060060600000660000066000606000006006000060000000000000000000000000000000000000000000000000000000000000000000000000000000000000000000000000000000000088888888888888888888888888888888800000000000000000000000000000000000000000000000000000000000000000000000000000000000000002
0000000000000000000000000000000000000000000000000000000000000000000100006060000600000060006006000600606000000606000066600006006000006600060006000600600606000600060000600660000000000000000000000000000000000000000000000000000000000000000000000000000008888888888888888888888888888888888888888000000000000000000000000000000000000000000000000000000000000000000000000000000000000000000000000000000000000002
0000000000000000000000000000000000000000000000006000000000060000000160000006606000000006060000606000060000000060000000000000660000000000006060000066000060000060600000066060000000000000000000000000000000000000000000008888888888888888888888888888888888888888880000000000000000000000000000000000000000000000000000000000000000000000000000000000000000000000000000000000000000000000000000000000000000000002
0000000000000000000000000000000000000000000000600000000000000000008100000000000000000000600000060000000000000000000000000000000000000000000600000000000000000006000000000060000088888888888888888888888888888888888888888888888888880000000000000000000000000000000000000000000000000000000000000000000000000000000000000000000000000000000000000000000000000000000000000000000000000000000000000000000000000002
1111111111111111111111111111111111111111111111111111111111111111111111111111111111111111111111111111111111111111111111111111111111111111111111111111111111111111111111111111111111111111111111111111111111111111111111111111111111111111111111111111111111111111111111111111111111111111111111111111111111111111111111111111111111111111111111111111111111111111111111111111111111111111111111111111111111111111