00000000000000000000000000000000000000000000000000000000000000000000000000000000000000000000000000000000000000000000000000000000000000000000000000000000000000000000000000000000000000000000000000000000
00000000000000000000000000000000000000000000000000000000000000000000000000000000000000000000000000000000000000000000000000000000000000000000000000000000000000000000000000000000000000000000000000000000
11111111111111111111111111111111111111111111111111111111111111111111111111111111111111111111111111111111111111111111111111111111111111111111111111111111111111111111111111111111111111111111111111111111
10000000000000000000000000000000000000000000000000000000000000000000000000000000000000000000000000000000000000000000000000000000000000000000000000000000000000000000000000000000000000000000000100010002
01000000100000111000000000000000000000000000000000000000000000000000000000000000000000000000000000000000000000000000000000000000000000000000000000000000000000000000000000000000000000000001001010101002
00100001010001000100000001000000000000000000006000000000000000000000000000000000000000000000000000000000000000000000000000000000000000000000000000000000000000000000000000000000000000000000110001000102
00010010001010000010000010000000000000000000006000000000004000000000000005400450000005400000045000000045000000500000000000000000000000000000000000000000000000000000000000000000000000000000000000000002
00001100000100000001000100000000000000000000000000000000000540000000000540000000000540000000000540545400000000050000010101101010000000100101101010101011010101010101010101101010101101010101000000000002
00000000000000000000101000000000000000000000000000000000000005000000054000000000054000000000000005000000000000000000000000000000000000000000000000000000000000000000000000000000000000000000000000000002
00000000000000000000010000000000000000000000000000000000000000400004500000000000000000000000000000000000000000000000000000000000000000070000000000000000000000000000000070000000000000077770000000000002
00000000000000000000000000000000000000000000006000000000000000000000000000000000000000000000000000000000000000000000000000000000000000000000000000000000000000000000000000000000000000000000000000000002
00000000000000000000000000000000000000000000000000000000000000000000000000000000000000000000000000000000000000000000000000000000000000000000000000000000000000000000000000000000000000000000000000000002
00000000000000000000000000000000000000000000000000000000000000000000000004000000000000000000000000000000000000000000000000000000000000000000000000000000000000000000000000000000000000000000000000000002
00000000000000000000000000000000000000000000006000000000000000000000000000010000110001000010011000100010100001400000000000000000000000000000000000000000000000000000000000000000000000000000000000000002
00000000000000000000000000000000000000000000006000000000001100000001444444101001001010110100000001000001000000000000000000000000000000000000000000000000000700000000000000000000700000000000000000000002
00000000000000000000000000000000000000000000000000000000100001000010100001000110000100001000000110000000000000000000000000000000000000000000000000000000000000000000000000000000000000000110000110000002
00000010000000000010001000001000000000000000006000000001000000101100011110000000000000000000000000000000000000000000000001001010110101010101010101010101010100001100010000101010100000000001000001000012
01100101100010000101010110010100000000000000000000000010000000010000000000000000000000000000000000000000000000000000000000000000000000000000000000000000000000000000000000000000000000100000101000101102
10010000010101011000100001100010000000000000000000000000000000000000000000000000000000000000000000000000000000000000000000000000000000000000000000000000000000000000000000000000000000000000010000010002
11111111111111111111111111111111111111111111111111111111111111111111111111111111111111111111111111111111111111111111111111111111111111111111111111111111111111111111111111111111111111111111111111111111