00000000000000000000000000000000000000000000000000000000000000000000000000000000000000000000000000000000000000000000000000000000000000000000000000000000000000000000000000000000000000000000000000000000
00000000000000000000000000000000000000000000000000000000000000000000000000000000000000000000000000000000000000000000000000000000000000000000000000000000000000000000000000000000000000000000000000000000
11111111111111111111111111111111111111111111111111111111111111111111111111111111111111111111111111111111111111111111111111111111111111111111111111111111111111111111111111111111111111111111111111111111
00000000000000000000000001000000100000000000000000000000800000000000000000000000000001000000000000000000000000000000000000000000000000000000000000000000000000000000000000000000000000000000000000000002
00000000000000000000000000000000000000000000000000000000000000000000000000000000000000400000000000000000000000000000000444444444444444444444444444444440000000000000000000000000000000000000000000000002
00000000000000000000000000000000000000000000000000000000000000800000000000000000000000005000000000000000000000000000000000033333333333333333333333333333333330000000000000000000000000000000000000000002
00000000000000000000000000000000000000000000000000000000000000000000000000000000000000000400000000000000000000000000000000003333333333333333333333333333333333000000000404004040404040040000000000000002
00000000000000000000000000000000000000000000000000000000007000000000000000000000000000000010000000000000000000000000000000000333333333333333333333333333333333300000000087878787878788800000000000000002
00000000000000000000000000000000000010000000000000000000000000000000000000000000000000000005000000000000000000000000000000000033333333333333333333333333333333330000000050550505050505050500000000000002
00000000000000000000000000000000000000000000000000000000080000000000000000000000000000000000000000000000000000000000000000000003333333333333333333333333333333333000000000000000000000000000000007000002
00000000000000000000000000000000000000000000000000000000000000000000000000000000000000000000000000000000000000000000000000000000333333333333333333333333333333333300000000000000000000000000000007000002
00000000000000000000000000000000000000000080000000000000000000000000000000000000000000000000004000000000000000000000000000000000033333333333333333333333333333333330000000000000000000000000000007000002
00000000000000000000000000000000000000000000000000000000000000000000000000000000000000000000000100000000000000000000000000000888888888888888888888888888888888888888800000000000000000000000000007000002
00000000000000000000000000000000000000000000000000000000080000000000000000000000000000000000000000000000000000000000000000000000000000000000000000000000000000000000000000000000000000000000000000000002
00000000000000000000000000000000000100000000000000000000000000000000000000000000000000000000000001000000000000000000000055555555555555555555555555555555555555555555500000000000000000000000000000000002
00000000000000000000000000000000000000000000000000000000000000000000080000000000070000000000000000510000000000000000000000000000333333333333333333333333333333333333333333333333333333300000000000000002
00000000000000000000000000000000000000000000000000000000000007000008008000000000000000000000000000000000000000000000000000000000000000000000000000000000000000000000000000000000000000000000000000000002
00000000000000000000000000000000000000000800000000000000000000008080000800000000000000000000000000000400000000000000000000000000000000000000000000000000000000000000000000000000000000000000000000000002
00000000000000000000000000000000000010000000000000000000000000000000000000000000000000000000000000000010000000000000000000000000000000000000004545454454545454545454544000000000000000000000000000000002
11111111111111111111111111111111111111111111111111111111111111111111111111111111111111111111111111111111111111111111111111111111111111111111111111111111111111111111111111111111111111111111111111111111