0000000000000000000000000000000000000000000000000000000000000000000000000000000000000000000000000000
0000000000000000000000000000000000000000000000000000000000000000000000000000000000000000000000000000
1111111111111111111111111111111111111111111111111111111111111111111111111111111111111111111111111111
0000000000000000000000000000000666666666666666000000000000000001000000000000000010000030000000000002
0000000000000000000000000000000000000000000000000000000000000001000000000000000010000333000000000002
0000000000000000000000000000000000000000000000000000000000000001000000000000000010000030000000000032
0000000000000000000000000000000000000000000000000000000000000010000000000000000010000000000000000002
0000000000000000000000000011111111111111111111111000000000000001000000000000000010000000000000003002
0000000000000000000000000000000000000000000000000000000000000001000000000000000010000000000000300002
0000000000000000000000001003330000000000333333333000000000000001000010000000000010000000000000000002
0000000000000000000000010033333333333330000001100000000033033333000010000000000010000033000000000002
0000000000000000000000100333000000000000011010011000000000003300000000000000000000000000001000000002
1111111111111111111111000330000000000000010000000000000000000000333300000000000333000000001000000002
0000000000000000000000000300000000000000100000000000000000000000333333333333333333333333301000000002
0000000000000000000000000000000000000000100000000000000000000000000000000000000000000000001000000002
0000000000000000000000000000000000000001000000000000000000000000000001000000000000000000001000000002
0011111111111111101111111111111111111111000000000000000000000000000001000000000000000000001000000002
0000000000000000000000000000000000000000000000000000000000000100000001000000000000000000001000000002
0000000000000000000000000000000000000000000000000000000000000100000001000000000000000000000000000002
1111111111111111111111111111111111111111111111111111111111111111111111111111111111111111111111111111