0000000000000000000000000000000000000000000000000000000000000000000000000000000000000000000000000000
0000000000000000000000000000000000000000000000000000000000000000000000000000000000000000000000000000
1111111111111111111111111111111111111111111111111111111111111111111111111111111111111111111111111111
0000000000000000000000000000400400400000000000000000000000000000000444444444444444444444000000000002
0000000000000000044440000000000000000000000000050505050505050500000000000000000000000000000000000002
0000000000000000000000000000000000000000000000000000000000000000000000000000000000000000000000000002
0000000000000000000000000000000000400000000000000000000000000000000000000000000000000000000000000002
0000000000000000000000000000000000000000000000000000000000000000000000000000000000000000000000000002
0000000000000000000000000000000000000000000000000000000000000000000000000000000000000000000000000002
0000000000000000000000000000000000000400000000000000000000000000000000000000000000000000000000000002
0000000000000000000000000000000000000000000000000000000000000333333333333333333333333333333333333332
0000000000000000000000000000000000000000000033333330000000000000000000000000000000000000000000000002
0000000000000033333333300000000000000000000000000000000000000000000000000000000000000000000000000002
0000000000000000000000000000000000000000040000000000000000000000000000000000000000000000000000000002
0000000000000000000000000000000000000000000000000000000000000000000000000000000000000000000000000002
0000000000000000000000000000000033300000000000000000000000000000000000000000000000000000000000000002
0000000000000000000000000000000000000000000000000000000000000000000000000000000000000000000000000002
0000000000000000000000000000000000000000000000050505050505050500000000000000000000000000000000000002
0000000000000000000000000000000000000000000000000000000000000000000555555555555555555555000000000002
1111111111111111111111111111111111111111111111111111111111111111111111111111111111111111111111111111