0000000000000000000000000000000000000000000000000000000000000000000000000000000000000000000000000000
0000000000000000000000000000000000000000000000000000000000000000000000000000000000000000000000000000
1111111111111111111111111111111111111111111111111111111111111111111111111111111111111111111111111111
0000000000000000000000000000000000000000000000000000000000000000000044444444444444444444444444444442
0000000000000000000000000000000000000000111111110000000000000000000033333333333333333333333333333332
0000000000000000001111111110000000000000000000000100000000000000000033333333333333333333333333333332
0000000000000000000000011110000000000000000000000010000000000000000055555555555555555555555555555552
0000000000000000000000000000111100000000000000000001000000000000000033333333333333333333333333333332
0000000000000000033333333333333300000000000000000000100000000000000033333333333333333333333333333332
0000000000001111300000000000000000003333333333333000010000000000000055555555555555555555555555555552
0000000000000030000000000000000000000000000000000003001000000000000033333333333333333333333333333332
0000000000000300000000000055555555500000000000000000300100000000000033333333333333333333333333333332
0000000000000000001111100044444444000000000000000000030010000000000000300003333333333333000000000002
0000000000000000000000000000000000000000000000000000003001003030030300000000000000000000000000000002
0000000000000000000000000000000000000000000000010000000300030000000000044444444444444444444444444442
0000000000000000000000000000000000000000000000100000000033000000000000000000000000000000000000000002
0000000000000000000000000000000000000000000001000000000000000000000000333333333333333333333333333332
0000000000000000000000000000000000000000000010000000000000000000000000055555555555555555555555000002
0000000000000000000000000000000000000000000000000000000000000555555000033333333333333333333333333332
1111111111111111111111111111111111111111111111111111111111111111111111111111111111111111111111111111