0000000000000000000000000000000000000000000000000000000000000000000000000000000000000000000000000000
0000000000000000000000000000000000000000000000000000000000000000000000000000000000000000000000000000
1111111111111111111111111111111111111111111111111111111111111111111111111111111111111111111111111111
0000040000000050000000000000000000000000010000000000000000000555555555555555555550000000000000000002
0000040000000005000000000000000000000000000100000000000000000333333333333333333330000000000000000002
0000040000000000500000000000000000000000000000000000000000000444444444444444444440000000000000000002
0000050000000000050000000000000000100000000000000000000000000011000000000000000000000000300000000002
0000050000000000000000000000000000000000000000000000000000000000110000000000000003000000000000000002
0000050000000000000000000000000000000000000333333333300000000000001100000000000000000003000000000002
0000050000000000000000000000000000010000000000000000000000000000000010000000000000000000000000000002
0000050000000000000000000000000000000000000000000000000000000000000001000000000000000030000000000002
0000050003333333333333333333333000000011111111111111111111111111111111000000000000000000000000000002
0000010000000000000000000000000000000000000000000000000000000000000001000000000030000000000000000002
0000000000000000000000000000000000010000000000000000000000000000000010000000000000003000000000000002
0000000000000000000000000000000000000000000000000000000000000000001100000000000000000000000000000002
0000010000000000040000000000000000000000000000000000000000000000110000000000000000000000000000000002
0000010000000000400000000000000010000000000000000000000000000011000000000300030003000000000000000002
0000010000000004000000000000000000000000000000000000000000000000000000000000000000000000000000000002
0000010000000040000000000000000000010000000000000000000000000000000000000000000000000000000000000002
1111111111111111111111111111111111111111111111111111111111111111111111111111111111111111111111111111