0000000000000000000000000000000000000000000000000000000000000000000000000000000000000000000000000000
0000000000000000000000000000000000000000000000000000000000000000000000000000000000000000000000000000
1111111111111111111111111111111111111111111111111111111111111111111111111111111111111111111111111111
0000000000000000000000000000000666666666666666000000000000000001000000000000000010000000000000000002
0000000000000000000000000000000000000000000000000000000000000001000000000000000010000000000000000002
0000000000000000000000000000000000000000000000000000000000000001000000000000000010000000000000000032
0000000000000000000000000000000000000000000000000000000000000010000000000000000010000000000000000002
0000000000000000000000000011111111111111111111111000000000000001000000000000000010000000000000003002
0000000000000000000000000000000000000000000000000000000000000001000000000000000010000000000000300002
0000000000000000000000001003333333333333333333333000000000000001000010000000000010000000000000000002
0000000000000000000000010033333333333333333333333000000033000000000010000000000010000033000000000002
0000000000000000000000100333011111111111111111111000000000003300000000000000000000000000001000000002
1111111111111111111111000330100000000000000000000000000000000000333300000000000333000000001000000002
0000000000000000000000000301000000000000000000000000000000000000000000000000000000000000001000000002
0000000000003333333333333011000000000000000000000000000000000000000000000000000000000000001000000002
0000000000000000000000011110000000000000000000000000000000000000000001000000000000000000001000000002
0011111111111111101111100000000000000000000000000000000000000000000001000000000000000000001000000002
0000000000000000000000000000000000000000000000000000000000000100000001000000000000000000001000000002
0000000000000000000000000000000000000000000000000000000000000100000001000000000000000000000000000002
1111111111111111111111111111111111111111111111111111111111111111111111111111111111111111111111111111