0000000000000000000000000000000000000000000000000000000000000000000000000000000000000000000000000000
0000000000000000000000000000000000000000000000000000000000000000000000000000000000000000000000000000
1111111111111111111111111111111111111111111111111111111111111111111111111111111111111111111111111111
0000000000010000000000000000000000000000000000000000000000000000000000000000000001000000000000000002
0000000000000000000000000000000000101000000000000000000000000000000000000000000000000333333333300002
0000000000000010101010000000000000030000000000000000000000000100000000000000000000000000010000000002
0000000000000000003330000000000000030000100000000000000000000000000000000000001001000000000000000002
0000000000000000000000010000000000030000000000000000000000000003303000000000000000000000000000000002
0000000000000000100000001000000000030000000000000000000000000030000300000000001003000300000000000002
0000000000000000100000000100000000030000000010000000000000100300001030000000000300030000000000000002
0000000000000000100000000000000000000000000000000000000000003000000003000000003000000000010000000002
0000000000000000100000000001000000000000000000000000000000030000000000300001030000000000000000000002
0000000000000000000000000000030303000000000010000000000000300000000000030000300000000000000000000002
0000000000000000033333330000000000000000000000000000000003000000000000003003000000000000000000000002
0000000000000000000300000000000000000000000000000100000030000000000010000300000000000000000000000002
0000000000000000003000000000000000000000030303003030000000000000000000000001000000000001000000000002
0000000000000000030000000000000010000000000000000000010000000000000000000000000000000000000000000002
0000000000000000300000000000000001000000000000000000000000000000000000010000000000000000000001000002
0000000000010000000000000000000000100000000000000000000303030030303000000000000000000000000000000002
1111111111111111111111111111111111111111111111111111111111111111111111111111111111111111111111111111