0000000000000000000000000000000000000000000000000000000000000000000000000000000000000000000000000000
0000000000000000000000000000000000000000000000000000000000000000000000000000000000000000000000000000
1111111111111111111111111111111111111111111111111111111111111111111111111111111111111111111111111111
0000000000000000000000000000000000000000000000000000000000000000000000000000000000000000000000000002
0000000000000000000000000000000000000000000000000000005000000000000000000000000000033030303300000002
0000000000000000000000000000000000000000000000000000050000000000005555055005500000300000000040440002
0000000000000000000000000000000000000000000000005555500000000000000000000005000033000000000003000002
0000000005555555555555500000000000000500000550550000550500000000000000000050000300000000004400300002
0000000000000000000000000000000000055055555005003333333050000000000000555500333000000000004400300002
0000000000000000000000000000000000500000333333333333333050000000000005033333000333300004044000330002
0000000000000000000000000000000030333333000000433333040400000000000000030000000030000000400000000002
0000000000000000000000000000000000000000004040000000400000000000000500030000004400030030000400300002
0000000000000000000000000000000000000000400000004040000000000000003333303000040040403300004000030002
0000000000000000000000000000000000004444000000000000003333333333033333330004003300040000040000300002
0000000000000000000000000000000000003333333333333333000000000000000000040400003000304404000000030002
0000000000000000000000000000000000000033333333333333333000000000000000000000000000004000000000030002
0000000000000000000000000000000000000555555555555555555500000000000000000333333333333333333300330002
0000000444444444444444400000000000000000000000000000000000000000000000000000000333333333333333000002
0000000000000000000000000000000000000000000000000000000000000000000000000000000000000000000000000002
1111111111111111111111111111111111111111111111111111111111111111111111111111111111111111111111111111