00000000000000000000000000000000000000000000000000000000000000000000000000000000000000000000000000000000000000000000000000000000000000000000000000000000000000000000000000000000000000000000000000000000
00000000000000000000000000000000000000000000000000000000000000000000000000000000000000000000000000000000000000000000000000000000000000000000000000000000000000000000000000000000000000000000000000000000
11111111111111111111111111111111111111111111111111111111111111111111111111111111111111111111111111111111111111111111111111111111111111111111111122211111111111111111111111111111111111111111111111111111
00000000000000000000000000000000000000000000000000000000000000005000000000000000000000000000000000000000000000000078000000000000000000000000000077700000000000000000000000000000000000000000000000000072
00000000000000000000000000000000000000000000005050000000000050400040000000000000000000000000540540000000000000000000000000000000000000000000000000038000000333000000000000000000000000000000000000000702
00000000000000000700000000000000000000000000000004054000050400000004504500540000000000000504000000000000000000000007800000000000000000000000000000000000000000000000000000000078800000000000000000077002
00000000000000000000000000000000000000000000000000000540400000000000000000005000000000004000000000000000000000000000000000000000000000000000000000000000000000000780000000000000000000000000000000000002
00000000000000000000070000000000000000000000000000000000000000000000000000000400045505400000000000000000000000000000777770000000000000000000000000000000000000087000000007880000000000000000000000070002
00000000000000000000000000000000000000000000000000000000000000000000000000000005400000000000000000000000000000000008000000000000000000008040000040000000000000000000000000000000000000000000000000000002
00000000000000000000000000000000000000000000000000000000000000000000000000000000000000000000000000000000000000000000000000000000000000000005088005450087880008700000080000708007800000000000000000000002
00000000000000000000000000000000075550000000000000000000000000000000000000000000000000000000000000000000000000088000780000000000000000000000400000000000007800000000007800000000000000000000000000007002
00000000000000000000000000000000000000000000000000000000000000000000000000000000000000000000000000000000000000000000000000000000000000000000000000000000000000000000000870000008000000000000000000007002
00000000000000000000000000000000006000000000000000006000000000000000000000000000000000000000000000000000000000000000007800000000000000000000000000000078007800000008000078000000000078000000000000000002
00000000000000000000000000000060660600000000000000000676767667676767767660000000000000000000000000000000000000000000780000000000000000000000000000000000000080000000000000000000000000000000000000007002
00000000000000000000000000000000000000000000006000000000000000000000000000000000000000000000000000000000000000000787800000000000000000000000000000000000000000080000000000780000000000000000000000000002
00000000000000000000000000000000000000000000060000060000000000000000000000000000000000000000000045000000000000000000778800000000000000000000000000000000008000080000000000000004800000000000000000000702
00000000000000000000080000000000000000000000000000000000000000000000000000000000000000000000004500450000000000000000078000000000000000007800000000000000000000000000000000000000000000000000000000000072
00000000000008000000800000000000000000000000000000000000000000000000000000000000005445544045450000004545000000000008000000000000000000000000000007800780333000000000000000000000000000000000000000000702
00000000000000000000000000000000000000000000000000000000000000000000000000000000450000000500000000000000000000000003333333000000000000000000000000000000000000000000000000000000000000000000000000007002
11111111111111111111111111111111111111111111111111111111111111111111111111111111111111111111111111111111111111111111111111111111111111111111111111111111111111111111111111111111111111111111111111111111