00000000000000000000000000000000000000000000000000000000000000000000000000000000000000000000000000000000000000000000000000000000000000000000000000000000000000000000000000000000000000000000000000000000
00000000000000000000000000000000000000000000000000000000000000000000000000000000000000000000000000000000000000000000000000000000000000000000000000000000000000000000000000000000000000000000000000000000
11111111111111111111111111111111111111111111111111111111111111111111111111111111111111111111111111111111111111111111111111111111111111111111111111111111111111111111111111111111111111111111111111111111
00000000000000000000000080000000000000000000000000000000000000000000000000000000000000000000000000000000000000800000000000000000000000000000000000000000000000000000000000000000000000000000000000000002
00000000000000000000000000000080000000000000000000000000000000000000000000000000000000000000000000000000000000080000000000000000000000000000000000000000000000000000000000000000000000000000000000000002
00000000000000000000000008808808000000000000000000000000000000000000000000000000000000000000000000000000000000008000000000000000000000000000000000000000000000000000000000000000008888888888888888888882
00000000000000000000000000080000800000000000000000000000000000000000000000000000883030303030800000000000000000000800000000000000000000000000000000000000000000000000000000000000000000007000000000000002
00000000000000000000000000000000088800000000000000000000008080000000000000000088000000000000080000000000000000000088000000000000000000000000000000000000000000000000000000000000000000000700000000000072
00000000000000000000000000000000000080000000000000000000080008080000000008808000000000000000008800000000000000000000800008000000000000000000000000000000000633833600000000000000000000000070000770000702
00000000000000000000000000000000000008000000000000000808000000008080080800000000000000000000000080000000000000000000080080800000000000000000000000000000000000000000000000000000000000000007007007707002
00000000000000000000000000000000000000880000000000808000000000000000800000000000000000000300000008000000000000000000008800080000000000000000000000000000000000000000000000000000000000000000770000070002
00000000000000000000000000000000000000008800000080000008000087000000000000000000000000000033330000800000000000000000000000008000000000000000000000000000000000000000000000000000000000000000000000000002
00000000000000000000000000000000000000000080000800000003800000000000000000000000000000000000333300880000000000000000000000000800000000000000000000000000000000000000000000000000000000000000000000000002
00000000000000000000000000000000000880000008808000000008000000000000000000000000000000000080000008008000000000000000000000000080000000000000000000000000000000000000000000000000000000000000000000000002
00000000000000000000000000000000000038800000000000000000000000000000000000000000003333000000000880000800000000000000000000000008800000000000000000000000000000000000000000000000000000000000000000000002
00000000000000000000000000000000000000000000000000000000000800000000000000000000008080008000008000000080808000000000000000000000000000000000000000000000000000000000000000000000000000000000000000000002
00000000000000000000008880008800008000000000000000000000000000000000000000000000880800080880080000000000000880000080000000000000000000000000000000000000000000000607060706070607060706070600000000000002
00000000000000000000080008080080080880088888000088888888800888000880088080808008000080800000800000000000000008008800000000000000000000000000000000000000000000000000000000000000000000000000000000000002
00000000000000000000000000800008800008800000888800000000088000888008800000000880000008000008000000000000000000800000000000000000000000000000000000000000000000000000000000000000000000000000000000000002
11111111111111111111111111111111111111111111111111111111111111111111111111111111111111111111111111111111111111111111111111111111111111111111111111111111111111111111111111111111111111111111111111111111