0000000000000000000000000000000000000000000000000000000000000000000000000000000000000000000000000000
0000000000000000000000000000000000000000000000000000000000000000000000000000000000000000000000000000
1111111111111111111111111111111111111111111111111111111111111111111111111111111111111111111111111111
1000000000000000000000000000010000000000000000000000000000000000000101000000000000000000000000000002
0100000000000000000000000000001000003330333333000000000000000000000101010000000000000000000000000002
0010000000000000000000000000000100003000000001330000000000000000001000001000000000000000000000003332
0001000000000000000000000000000010003000000000103000300033330000000000000100000000000000000003330002
0000100000000000000000000000000001333000000000010303033300000300000000000010000000000000000033003002
0000010000000000000003030303300000300000000000001300000000001030000000000001000000000000000333300002
0000001000000000000003333333333030000000000000300000000000001003000003000000100000000000000030030002
0000000100000000000000000000003033300000000033000030003300001003000000030000010000000000003033300002
0000000010000000000000000000000001300000033330000000000030001000301000003030001000000000030003000002
0000000001000000000000000000000001030330300000000000000030001000300100300000000100000000333300000002
0000000000100000000000000000000000003000000000000110000030001000001000303003000310000003030000000002
0000000000000000000000000000000000000000000000001100000030001000010000033030303001000033330000000002
0000000000000000000000000000000000000000111111111000000030001003001000003003000030000030000000000002
0000000000000000000000000000000000000011000000000000000333333000000100000000300303030300000000000002
0000000000000000000000000000000000000010000000000000000000000000000100000030303000000000000000000002
0000000000000000000000000000000000000100000000000000000000000000001000000000000000000000000000000002
1111111111111111111111111111111111111111111111111111111111111111111111111111111111111111111111111111