00000000000000000000000000000000000000000000000000000000000000000000000000000000000000000000000000000000000000000000000000000000000000000000000000000000000000000000000000000000000000000000000000000000
00000000000000000000000000000000000000000000000000000000000000000000000000000000000000000000000000000000000000000000000000000000000000000000000000000000000000000000000000000000000000000000000000000000
11111111111111111111111111111111111111111111111111111111111111111111111111111111111111111111111111111111111111111111111111111111111111111111111111111111111111111111111111111111111111111111111111111111
00000000000000000000000000000000000000000000000000000000000000000000000000000000800000000000000000000000000000000000000000000000000000000000000000000000000000000000000000000000000000008000000000000002
00000000000000000000000000080000000000000000000000000000000000000000000000000000080000080000000000000000000000000000000000000080880800088000088000000000000000008080000000000000000000000000000000000002
00000000000000000080880000808800000000000000000000000000000030000000000000000000008000808000000000000000000000000000000000000000000080800800800800008008080000080008000000000000000000008000000000000002
00000000000000000000000880003333300000000000000000000033000303000000000000000000000888000800000000000000000000000000000000000000000008000088000080080000008080800000880800000000000000000000000000000002
00000000000000000000000000007788000000000000000000000300303000300000000000000000000000000080000000000000000000000000000000000000000000000000000008000000000000000000000000000000000000000000000000000002
00000000000000000000000000000077800000000000000000003000030000030000000000000000000030000008000800000000000000000000000000000000000000000000000000000000000000000000000000000000000000008000000000000002
00000000000000000000000000000000333300000000000000030000000008000000000000000000000007000000808080000880000000000000000030300000000000000000000000000000000000000000000000000000000000000000000000000002
00000000000000000000000000000000707000000000000000300000000080008000000000000000000000307000080008088008000000000000033000030003033000000303700730700000033773370000000003703000000000000000000000000002
00000000000000000000000000000000780000000000000003000000000800000088080000000000000000070300000000800000000000000000000000003300000030330000000000030073700000003737000730000000000000008000000000000002
00000000000000000000000000000000078000000000000330000000008000000000000800000000000000000070000000000000000000000077000000000000000000000000000000000700000000000000737000000000000000000000000000000002
00000000000000000000000000000000007800000000000000000000080000000000000000000000000000000003000000000000000333000000000000000000800000000000000000000000000000000000000000000000000000000000000000000002
00000000000000000000000000000000000780000000000000000808000000000000000080000000000000000000000000000000070000733300000000000080080000800000080000800000800000000000000000000000000000008000000000000002
00000000000000000000000000000000000000000000000000080000000000000000000000000000000000000000000000000000000000070000000000008800000008080000808008080008000000000000000000000000000000000000000000000002
00000000000000000000000000000000000007800000000008000000000000000000000000000000000000000000000000000000000000000000000808080000008080008088000880008880000000000000000000000000000000008000000000000002
00000000000000000000000000000000000000778080088080000000000000000000000000000000000000000000000000000000000000000080808000000000000800000800000000000000000000000000000000000000000000000000000000000002
00000000000000000000000000000000000000007777777800000000000000000000000000000000000000000000000000000000000000000800000000000000000000000000000000000000000000000000000000000000000000008000000000000002
11111111111111111111111111111111111111111111111111111111111111111111111111111111111111111111111111111111111111111111111111111111111111111111111111111111111111111111111111111111111111111111111111111111