0000000000000000000000000000000000000000000000000000000000000000000000000000000000000000000000000000
0000000000000000000000000000000000000000000000000000000000000000000000000000000000000000000000000000
1111111111111111111111111111111111111111111111111111111111111111111111111111111111111111111111111111
0000000000000000000000000000000000030003330030000000000000000000000000000000000000000000000000000002
0000000000000000000000000000000000000000000000000000000000000000000000000000000000000000000000000002
0000000000000000000000000000000100000030030000000000000000000030000000001000000000000000100000000002
0000000000000000000000000010000000000300000030000003000000000030000030000000000000003000000003000002
0000000000000000000003000310003000003000000000030000000031000030000103000000000000003000000000300002
0000000000000000000000000000000000030000000010003030300000000030000000300000000000003000000000030002
0000000000000000000000000000000000300000000000000000000000000030000010030000000000003000000000003002
0000000000000000000000000001000003000000000000000000001331000000000000003000000000003000000000103002
0000000000000000000000000001000030000000000000000000030000000000000000000300000000003000000000000002
0000000000000000000000010001000300000100000030000300000000000000000000001030000000003000000000000002
0000000000000000000000000001000000000000000000000000000000000000000000000000300000300000000000003002
0000000000000000000000000000000000000000000000000000001010111001011000000000000003000000000000000002
0000000000000333333333333300003030303000000000300000000000000000000000000000000030000000000000000002
0000000000000000000000000001000000000000000000000000000000000000000000000000000300000000000000000002
0000000000000000000000000001000000000000000000000300000000000000000000000000000000000000000000000002
0000000000000000000000000001000000000000000000000000033333003033300000000000000000000000000000000002
1111111111111111111111111111111111111111111111111111111111111111111111111111111111111111111111111111