00000000000000000000000000000000000000000000000000000000000000000000000000000000000000000000000000000000000000000000000000000000000000000000000000000000000000000000000000000000000000000000000000000000
00000000000000000000000000000000000000000000000000000000000000000000000000000000000000000000000000000000000000000000000000000000000000000000000000000000000000000000000000000000000000000000000000000000
11111111111111111111111111111111111111111111111111111111111111111111111111111111111111111111111111111111111111111111111111111111111111111111111111111111111111111111111111111111111111111111111111111111
00000000000010000000000000000000000000000000000000000008000000000000455454545454545454500000000000000000000000008000000000000000000000000000000000000000000000000000000000000000000000000000000000000002
00000000000001000000000000000000000000000000000000003333000000000000000000000000000000000000000000000000000000000000000000000000000000000000000000000000000000000000000000000000000000000000000000000002
00000000000000100000000000000000000000000000000000030038000000000000800080000000000000000000300000000000000000000800000000000000003000000000000000000000000000000000000000000000000000000000000000000002
00000000000000080000000000000000000000000000000003303333000000000000008000800000000000000033030000000000000000003388000000000000000300000000000000000000000000000000000000000000003000000000000000000002
00000000000000008000000000000000000000000000003030000038000000000000000000000080000000000300003000000000003333030000800000000000000033000000000000000000000008000000000000000000030300000000000000000002
00000000000000000800000000000000000000000000330300003333300000000000000000080800000000003000000300000000330000000000080000000000000000300000000000000000000000800000000000000000300030000000000000030002
00000000000000000080000000000000000000000003000000000000330000300000030000008000000030030000000030000003000000000000008000000000000000030000000000000000000000080000000000000033000003000000330000300002
00000000000000000008000000000000000000000030000000000003003003033000303003300033003303300000000003000030000030000000000000000000000000003000000000000000000000008000000030030300000000300003003003000002
00000000000000000000100000000000000000000000000000030030000330000003000330030300330000000000000000303300000003000003303000000000000000000300003000000300000000030300000300000000000000033330000330000002
00000000000000000000000000000000000000000303000000330338000000000330000000003000000000000000000000030000000000300030030000000000000000000030030300003033000000300033000000000000000000000000000000000002
00000000000000000000000000000000000000003000300003000000000000000000000000000000000000000000000000000000000000033333300000000000000000000003300030030000303030000000303000000000000000000000000000000002
00000000000000000000000000000003333333330000003030000000000000000000000000000000800000000000000000000000000000003333330000000000000000000000000003300000000000000000030000000000000000000000000000000002
00000000000000000000000000000000000000000000000003333308000000000000000000000080000000000000000000000000000000033000030000008000000000000000000000000000000000000000000008000000000000000000000000000002
00000000000000000000000000000000000000000000000003000330000000000000000080808000000000000000000000000000000000000330333000800088000000008000000000000000000000000000080800880000080000000000000000000002
00000000000000000000000000000000000000000000000000000038000000000000080800000000000000000000000000000000000000000000088080000000808000800000000000000000000000000088000000008088000000000000000000000002
00000000000000000000000000000000000000000000000000000000000000000000454554545454545444500000000000000000000000000000800000000000000080000000000000000000000000808000000000000800000000000000000000000002
11111111111111111111111111111111111111111111111111111111111111111111111111111111111111111111111111111111111111111111111111111111111111111111111111111111111111111111111111111111111111111111111111111111