00000000000000000000000000000000000000000000000000000000000000000000000000000000000000000000000000000000000000000000000000000000000000000000000000000000000000000000000000000000000000000000000000000000
00000000000000000000000000000000000000000000000000000000000000000000000000000000000000000000000000000000000000000000000000000000000000000000000000000000000000000000000000000000000000000000000000000000
11111111111111111111111111111111111111111111111111111111111111111111111111111111111111111111111111111111111111111111111111111111111111111111111111111111111111111111111111111111111111111111111111111111
00000000000000000000000000000000000000000000000000000000000000000000000000000000000000000000000060000080000000000000000000000000000000000000000000000000000000000000000000000000000000000000000000000002
00000000001000000000000000000000000000000000000000000031000000000000000000000000000000000000000000000080000000000000000000000000000000000000000000000000000000000000000000000000000000000000000000000002
00000000000000000000000000000000000080008000000000001310000000000000000000000000000000000000000000000080000008000008000000000000000000000000000000000000000000000000000000000000000000000000000000000002
00000000000000100000001100000000008000000800000000013000010000000000000000000000000000000101000060000000000000000000000000000000000000000000000000000000000000000000000000000000001100000110000000000002
00000000000000010000000000000000080000000000000001333333333333330000000000000000000000011000100000000000000000000000000000000000000000000000000000000000000000000000000000000100000011010000000000000002
00000000000000000010000000000008800000000000000000000000000000000000000000000000000000100000001000000000000010000000008000080000000000000000000000000000000100000000000000000000000000000000000000000002
00000000000000000000000000010000000000000080000000000000000000000000000000000000000000080000070000000000000001000000000000000000000000000000000000000000000000000000000000100000000000000000000000000002
00000000000000000000000000000880000100000008000000000000000000000000000000000000000100000000000000000000000800110000010000000000000000000000000000000000000110000000000000000000000000000000000000000002
00000000000000000000000000008000000001100000800000000080000000000000000000000000001080000000000000000000088000001000100000000000000000000000000000000000000000000000000010000000000000000000000000000002
00000000000000000000000000000000000000000000000000080000000000000000000000000000000800080000000000000000800000000100000000000000000008000000000000000000000100000000000000000000000000000000000000000002
00000000000000000000000000000000000000003100008000000000780000010100000000000010800000008000000000000008000000000011000000008000000000000000000000000000000000000000000000100000000000000000000000000002
00000000000000000000000000000000000000031000000080000000000000000000000101101008000000000000000000000080000000000000000000000000000800000000000000000000000000000000000000000000000000000000000000000002
00000000000000000000000000000000000000000000000000000000078000000001000000000000000000070800000000000000000000000000000000000000000000000000000000000000001000000000000001000000000000000000000000000002
00000000000000000000000000000000000000000000000000000000000000000000010000000000000000000000000000000000070000000000000000000800080000000000000000000000000000000000000000000000000000000000000000000002
00000000000000000000000000000000000000000000000000000000000000000000000000000000000000000000000000000000000000000000000000000000000000000000000000000000000000000000000000000000000000000000000000000002
00000000000000000000000000000000000000000000000000000000000000077777770000000000000000000000000000000000000000000000000000000000000000000000000000000000000000000000000000000000000000000000000000000002
11111111111111111111111111111111111111111111111111111111111111111111111111111111111111111111111111111111111111111111111111111111111111111111111111111111111111111111111111111111111111111111111111111111