0000000000000000000000000000000000000000000000000000000000000000000000000000000000000000000000000000
0000000000000000000000000000000000000000000000000000000000000000000000000000000000000000000000000000
1111111111111111111111111111111111111111111111111111111111111111111111111111111111111111111111111111
0000000000000000500000000000000000000000000000000000000000000000000000000000000000000000000000000002
0000000000000005000000000000000000000000000333333333333333333333333333333333333333333330000000000002
0000000000000550000000000000000000000000000000333333333333333333333333333333333333300000000000000002
0000000000005000000000000000000000000000000000000000000000000000000000000000000000000000000000000002
0000000000050000000000400000000000000000000000000000000044000000000003333333333333333333300000000002
0000000000500000000000000000000000000000000000000000000400000000000000000010000000000000000000000002
0000000005000000000000004000000000000000000000000000054000000000000000000100000000000000000000000002
0000000050000000000000000000000000000000000000000005400045454000000000001444444444444444444444444402
0000000500000000000000000000000000003300000000000000000000000000000000001555555555555555555555555552
0000000000000000000000000000000000300003000045454450000044045000000000010000000000000000000000000002
0000000000000000000000000000000030000000000400000000000000454000000000100000000000000000000000000002
0000000000000000000000000000040033030003045000000000000004545000000001100000000000000000000000000002
0000000000000000000000000033333300000054500000000000000000455000000000000000000000000000000000000002
0000000000000000000000003333333330045400000000000000000004545000000000000000000000000000000000000002
0000000000000000000000003333330045400000000000000000000000445000000000000000000000000000000000000002
5000000000000000000000000000004500000000000000000000000000540000000000000000000000000000000000000002
1111111111111111111111111111111111111111111111111111111111111111111111111111111111111111111111111111