0000000000000000000000000000000000000000000000000000000000000000000000000000000000000000000000000000
0000000000000000000000000000000000000000000000000000000000000000000000000000000000000000000000000000
1111111111111111111111111111111111111111111111111111111111111111111111111111111111111111111111111111
0000000000000000000001000000000001000000000000000000000000000000000000000001000000000010000003000012
0000000000000000000001000000000001000000000000033333000000000000000000000001000000000010000003000012
0000000000000000000001000000000001000000000000333333000000000000000000000001000000000010000003000012
0000000000000000000001000000000001000000000003300000000000010000300000000001000000000010000003000012
0000000000000000000001000000000001000000000033000000000000010000300000000001000000000010000003000002
0000000000000000000001000000000001000000000330000000000000010000300000000001000000000010000003000002
0000000000000000000001000000000001000000003300000000000000010000300000000001000000000010000003000002
0000000000000000000001000000000001000000033000000000000000010000300000000000000000000010000003000002
0000000000000000000001000000000001000003330000000000000000010000300000000000000000000010000003000002
0000000000000000000001000000000001000033000000000000000000010000300000000000000000000010000003000002
0000000000000000000001000000333333000330000000000000000000010000300000033330000000000010000003000002
0000000000000000000003000000333333000300000000000000000000010000000000000000000000000010000003000002
0000000000000000000003000000300001000000000000000000000000010000000000000000000000000010000003000002
0000000000000000000000000000000001000000000000000000000000010000000000000000000000000010000003000002
0000000000000000000001000000000001000000000000000000000000010000000000000000000000000000000003000002
0000000000000000000001000000000001000000000000000000000000010000000000000000000000000000000000000002
1111111111111111111111111111111111111111111111111111111111111111111111111111111111111111111111111111